//MAP CONVERTED BY dmm2tgm.py THIS HEADER COMMENT PREVENTS RECONVERSION, DO NOT REMOVE
"cp" = (
/obj/effect/decal/cleanable/dirt,
/turf/open/floor/plating/airless,
/area/shuttle/ert)
"lp" = (
/turf/open/floor/plating/airless,
/area/shuttle/ert)
"Fn" = (
/turf/open/space/basic,
/area/template_noop)
"Tp" = (
/obj/docking_port/stationary/emergency_response/vaipo{
	dir = 1
	},
/turf/open/floor/plating/airless{
	opacity = 100
	},
/area/shuttle/ert)

(1,1,1) = {"
Fn
Fn
Fn
Fn
Fn
Fn
Fn
Fn
Fn
Fn
Fn
Fn
Fn
Fn
Fn
lp
lp
lp
lp
lp
lp
Fn
Fn
Fn
Fn
Fn
Fn
Fn
Tp
"}
(2,1,1) = {"
Fn
Fn
Fn
Fn
Fn
Fn
Fn
Fn
Fn
Fn
lp
lp
lp
lp
lp
lp
lp
lp
lp
lp
lp
lp
lp
lp
lp
Fn
Fn
Fn
Fn
"}
(3,1,1) = {"
Fn
Fn
Fn
Fn
Fn
Fn
Fn
Fn
Fn
Fn
lp
lp
lp
lp
lp
lp
lp
lp
lp
lp
lp
lp
lp
lp
lp
lp
Fn
Fn
Fn
"}
(4,1,1) = {"
Fn
Fn
Fn
Fn
Fn
lp
lp
lp
lp
lp
lp
lp
lp
lp
lp
lp
lp
lp
lp
lp
lp
lp
lp
lp
lp
lp
Fn
Fn
Fn
"}
(5,1,1) = {"
Fn
Fn
Fn
Fn
Fn
lp
lp
lp
lp
lp
lp
lp
lp
lp
lp
lp
lp
lp
lp
lp
lp
lp
lp
lp
lp
lp
Fn
Fn
Fn
"}
(6,1,1) = {"
Fn
lp
lp
lp
lp
lp
lp
lp
lp
lp
lp
lp
lp
lp
lp
lp
lp
lp
lp
lp
lp
lp
lp
lp
lp
lp
lp
lp
Fn
"}
(7,1,1) = {"
lp
lp
lp
lp
lp
lp
lp
lp
lp
lp
lp
lp
lp
lp
lp
lp
lp
lp
lp
lp
lp
lp
lp
lp
lp
lp
lp
lp
lp
"}
(8,1,1) = {"
lp
lp
lp
lp
lp
lp
lp
lp
lp
lp
lp
lp
lp
lp
lp
lp
lp
lp
lp
lp
lp
lp
lp
lp
lp
lp
lp
lp
lp
"}
(9,1,1) = {"
lp
lp
lp
lp
lp
lp
lp
lp
lp
lp
lp
lp
lp
lp
lp
lp
lp
lp
lp
lp
lp
lp
lp
lp
lp
lp
lp
lp
lp
"}
(10,1,1) = {"
lp
lp
lp
lp
lp
lp
lp
lp
lp
lp
lp
lp
lp
lp
cp
lp
lp
lp
lp
lp
lp
lp
lp
lp
lp
lp
lp
lp
lp
"}
(11,1,1) = {"
lp
lp
lp
lp
lp
lp
lp
lp
lp
lp
lp
lp
lp
lp
lp
lp
lp
lp
lp
lp
lp
lp
lp
lp
lp
lp
lp
lp
lp
"}
(12,1,1) = {"
Fn
lp
lp
lp
lp
lp
lp
lp
lp
lp
lp
lp
lp
lp
lp
lp
lp
lp
lp
lp
lp
lp
lp
lp
lp
lp
lp
lp
Fn
"}
(13,1,1) = {"
Fn
Fn
Fn
Fn
Fn
lp
lp
lp
lp
lp
lp
lp
lp
lp
lp
lp
lp
lp
lp
lp
lp
lp
lp
lp
lp
lp
Fn
Fn
Fn
"}
(14,1,1) = {"
Fn
Fn
Fn
Fn
Fn
lp
lp
lp
lp
lp
lp
lp
lp
lp
lp
lp
lp
lp
lp
lp
lp
lp
lp
lp
lp
lp
Fn
Fn
Fn
"}
(15,1,1) = {"
Fn
Fn
Fn
Fn
Fn
Fn
Fn
Fn
Fn
Fn
lp
lp
lp
lp
lp
lp
lp
lp
lp
lp
lp
lp
lp
lp
lp
lp
Fn
Fn
Fn
"}
(16,1,1) = {"
Fn
Fn
Fn
Fn
Fn
Fn
Fn
Fn
Fn
Fn
lp
lp
lp
lp
lp
lp
lp
lp
lp
lp
lp
lp
lp
lp
lp
Fn
Fn
Fn
Fn
"}
(17,1,1) = {"
Fn
Fn
Fn
Fn
Fn
Fn
Fn
Fn
Fn
Fn
Fn
Fn
Fn
Fn
Fn
lp
lp
lp
lp
lp
lp
Fn
Fn
Fn
Fn
Fn
Fn
Fn
Fn
"}
